1111111111112222211111111111111111111111111112222222222222222
111AAAAA111122221AAA1AAAAA1AA1A1AA1AAAAA1AAA122222AAAAAAAAA22
11AAAAAAA11122221AAAAAAAAAAAAAAAAAAAAAAAAAAA122222AAAAAAAAA22
11AAAAAAA11122221AAA1AAAAA1AA1A1AA1AAAAA1AAA122222AAAAAAAAA92
1AAA333AAA11222211A11111111111B11111111111A1122222AAAAAAAAA22
1AAA333AAA1122221AAA122222222BBB222222221AAA122222AAAAAAAAA22
1AAA333AAA1122221AAA12222222BBBBB22222221AAA122222AAAAA222222
11AAAAAAA11122221AAA12222222BBBBB22222221AAA122222AAAAA222222
11AAAAAAA11122221AAA12222222BBBBB22222221AAA122222AAAAA222222
111AAAAA111122221AAA122222222BBB222222221AAA122222222AA222222
11111A11111122221AAA122222222252222222221AAA122222AAAAA222222
2225BBB5522222221AAA122222222222222222221AAA122222AAAAA222222
2225BBB55222222222A2222222222222222222221AAA122222AA222222222
22222B2222222222AAAAA222222222222222222222A2222222AAAAA222222
2222BBBBBBBBBBB2AAAAA2AAAAAA3AAA3AAAAAAA2AAA222222AAAAA222222
2222BBBBBBBBBBBBAAAAAAAAAA3AAA3AAA3AAAAAAAAA222222222AA222222
2222BBBBBBBBBBB2AAAAA2AAAAAA3AAA3AAAAAAA2AAA222222AAAAA222222
222222222222222222A22222222222222222222222A2222222AAAAA222222
22222222222222222AAA222222222222222222222AAAAAA222AA222222222
22222222222222222AAA2222222222222222222222A2AAA222AAAAA222222
22222222222222222AAA222222222555222222222AAA2AA222AAAAA222222
22222222222222222AAA222222223BBB322222222AAA2AA222AAAAA222222
22222222222222222AAA22222227BBBBB62222222AAA2AAA22AAAAA222222
22222222222222222AAA22222227BBBBB62222222AAA2AAA22AAAAA222222
22222222222222222AAA22222227BBBBB62222222AAA2AAAA2AAAAA222222
22222222222222222AAA222222223BBB322222222AAA2AAAA2AAAAA222222
22222222222222222AAA2222222223B3222222222AAA2AAAA2AAAAA222222
22222222222222222AAA2222222222B2222222222AAA2AAAAAAAAAA222222
22222222222222222AAA2AAAAA2AA2A2AA2AAAAA22A22AAAAAAAAAA222222
222222222222222222AAAAAAAAAAAAAAAAAAAAAAAAAA2AAAAAAAAAA222222
22222222222222222AAA2AAAAA2AA2A2AA2AAAAA2AAA2AAAAAAAAAA222222
2222222222222222222222222222222222222222222222222222222222222
